;To jest komentarz
;Jesli linia zaczyna sie od ';', zostanie ona zignorowana
;Dane mapy musza znajdowac sie bezposrednio za komentarzem
; 0 - pusta przestrzen, 1 - blok twardy, 2 - blok kruchy
000020020200000222200
010121010101010101010
000020200200200000000
010101010101010101010
000200200002000000000
010101010101010101010
020000020002000000000
010101010121010101010
000000000222000000000
010101010101010101010
000000220020000000000
010101010101010101010
000000220200000000000
010101010101010101010
000000000000000000000