;To jest komentarz
;Jesli linia zaczyna sie od ';', zostanie ona zignorowana
;Dane mapy musza znajdowac sie bezposrednio za komentarzem
; 0 - pusta przestrzen, 1 - blok twardy, 2 - blok kruchy
00002002020000022220
01012101010101010101
00002020020020000000
01010101010101010101
00020020000200000000
01010101010101010101
02000002000200000000
01010101012101010101
00000000022200000000
01010101010101010101
00000022002000000000
01010101010101010101
00000022020000000000
01010101010101010101
00000000000000000000