[quantity]
n=12
[paths]
4 0,9 0,10 2,10 2,4
9 4,3 4,4 3,4 4,4 4,6 3,6 4,6 4,8 3,8
7 7,0 6,0 6,6 8,6 8,2 6,2 6,7
5 7,8 13,8 7,8 8,8 8,7
6 9,0 10,0 10,4 12,4 12,6 15,6
2 14,3 18,3
6 15,2 16,2 16,8 18,8 18,7 18,9
10 19,0 20,0 20,2 22,2 22,1 22,2 20,2 20,4 22,4 22,5
9 22,10 22,8 21,8 22,8 22,7 22,8 23,8 22,8 22,10
4 20,9 20,10 28,10 28,7
6 28,4 24,4 24,6 26,6 26,4 24,4
8 27,0 26,0 26,1 26,0 24,0 24,1 24,0 23,0
