[background]
r=247
g=186
b=62
[dimensions]
r=11
c=29
[data]
00000200200022002020022000002
01210101010121010101010101012
00202000020020200202000220202
01210101010101010121012101010
22000200000002020202000200000
01010101010101010101210101010
22000200000000000020002200002
01010101012121010101010101010
22000220000000220002200020200
01010101212121212101010101010
00022002220002002022000000000