[background]
r=60
g=200
b=150
[dimensions]
r=11
c=29
[data]
00022022222002202002002200000
01210121210101210101210101210
02222200222020200002220020000
01010121010101012101010101010
00022020000000022222200000020
01012101012101010101012101210
02200020022000022222202002222
01010101212121012101010121012
20000002020200202000022002020
21210101010121010121012101012
20200002022202002020000020000