[quantity]
n=9
[paths]
4 0,3 0,7 0,4 2,4
7 2,7 2,8 7,8 7,7 7,8 5,8 5,6
4 1,8 6,8 6,10 3,10
7 7,4 14,4 7,4 10,4 9,4 10,4 14,4
2 8,8 8,10
4 17,8 20,8 20,10 23,10
6 25,10 28,10 26,10 26,7 26,10 25,10
8 22,1 22,4 26,4 26,2 28,2 28,0 24,0 24,1
3 24,3 24,6 23,6